========== =========
=                  =
==========         =

=    ===============
=                  =
========== =========